00100000000000000000000000000000000000000001
00100000000000000000000000000000000000000001
00100000000000000000000000000000000000000001
00100000000000000000000000000000000000000001
00100000000000000000000000000000000000000001
00100000000000000000000000000000000000000001
00100000000000000000000000000000000000000001
00100000000000000000000007000000000000000001
00100000000000000000000002000000000000000001
00100000000000000000000021200000000000000001
00100000000000000000022211122200000000000001
00100000000000000000044444444400000000000001
00100000000000000000000000000000000000000001
00100000000000000000000000000000000000000001
00100000002222222200000000000000000000000001
00100000000000000000000000000000000000000001
0010000000000000000000222222222000000000000001
00100000000000000000000000000000000000000001
00100000000000000000000000000000000000000001
00100000000000000000000000000000000222222221
00100000000000000000000000000000000000000001
00100000000000000000000000000000000333333331
00100000002222222222222222222222222222222221
0010000000000000000000000000000000000000008
0010000000000000000000000000000000000000008
2222222222222222222222222222222222222222221
1111111111111111111111111111111111111111111
1111111111111111111111111111111111111111111
1111111111111111111111111111111111111111111
1111111111111111111111111111111111111111111
1111111111111111111111111111111111111111111
1111111111111111111111111111111111111111111