0011500000001111111111111111111111111111111
0011500000004444444444444444444444444444441
0011500000000000000000000000000000000000061
0011500000000000000000000000000000000000061
0011520000000000000000000000000000000000061
0011500000000000000000000000000000000000061
0011500000000000000000000000000000000000061
0011502220000000000000000000000000000000061
0011501110000000000000000000000000000000061
0011500400000000000000000000000000000000061
0011500000000000000000000000000000000000061
0011500000000062225000000000000000000000061
0011500000000004140000000000000000000000061
0011500000000000400000000000000000000000061
0011500000000000000000000022000000000000061
0011500002200000000000000001220000000000061
0011500001150000000000000000000000000000061
0011500000000000000000000000000000000000061
0011500000000000000003333000000000000000061
0011500000000000222222222000000000200000061
0011500000000000000000000000000000100000061
0011500000000000000000000000000000100000061
0011500000000000000000000000000000100000061
0011500000000000000000000000000002100000061
0011500000000000000000000000000001100000061
0011500000000000000000000000000001100000061
0011500000000000000000000000000001133333361
1111222222222222222222222222222221122222222
1111111111111111111111111111111111111111111
1111111111111111111111111111111111111111111
1111111111111111111111111111111111111111111