00100000000000000000000000000000000000000001
00100000000000000000000000000000000000000001
00100000000000000000000000000000000000000001
00100000000000000000000000000000000000000001
00100000000000000000000000000000000000000001
00100000000000000000000000000000000000000001
00100000000000000000000000000000000000000001
00100000000000000000000000000000000000000001
00100000000000000000000000000000000000000001
00100000000000000000000000000000000000000001
00100000000000000000000000000000000000000001
00100000000000000000000000000000000000000001
00100000000000000000000000000000000000000001
00100000000000000000000000000000000000000001
00100000000000000000000000000000000000000001
00100000000000000000000000000000000000000001
00100000000000000000000000000000000000000001
00100000000000000000000000000000000000000001
00100000000000000000000000000000000000000001
00100000000022000000000000000200000000000001
00100000000611000000000000000100000033333331
00100000000611000000000000000150000011111111
00100000000611000000000002200150000044444441
00100000000011333333300021133103330000000000
2222222222221122222222221112212222222222222
1111111111111111111111111111111111111111111
1111111111111111111111111111111111111111111
1111111111111111111111111111111111111111111
1111111111111111111111111111111111111111111
1111111111111111111111111111111111111111111
1111111111111111111111111111111111111111111
1111111111111111111111111111111111111111111