00100000000000000000000000000000000000000001
00100000000000000000000000000000000000000001
00100000000000000000000000000000000000000001
00100000000000000000000000000000000000000001
00100000000000000000000000000000000000000001
00100000000000000000000000000000000000000001
00100000000000000000000000000000000000000001
00100000000000000000000000000000000000000000
00100000000000000000000000000000000000000000
00100000000000000000000000000000000000000000
00100000000000000000000000000000000000000000
00100000000000000000000000000000000000000000
00100000000000000000000000000000000002222221
00100000000000000000000000000000000021111111
00100000000000000000000000000000000211111111
00100000000000000000000000000000002111111111
00100062222222222222222222222222221111111111
00100000000000000000040000000440000000000001
00100000000000000000000000000000000000000001
00100000000000330000000033300000000000000001
00111111111111111111111111111111111100000001
00100000000000000000000000000000400000000001
00100000000000330000000300000000000000000001
1111111111111111111111111111111111111111111
1111111111111111111111111111111111111111111
1111111111111111111111111111111111111111111
1111111111111111111111111111111111111111111
1111111111111111111111111111111111111111111
1111111111111111111111111111111111111111111
1111111111111111111111111111111111111111111
1111111111111111111111111111111111111111111
1111111111111111111111111111111111111111111