00100000000000000000000000010000020000000001
00100000000000000000000000010000111000000001
00100000000000000000000000010001010100000001
00100000000000000000000000010000101000000001
00100000000000000000000000011111111111111111
00100000000000000000000000000000000000000000
00100000000000000000000000000000000000000000
00100000000000000000000002222222222222222221
00100000000000000000000001000000000000000001
00100000000000000000000000000000000000000001
00100000000000000022000000000000000000000001
00100000000000000011000000000000000000000001
00100000000000000000000000000000000000000001
00100000000000000000000000000000000000000001
00100000000000000000000000000000000000000001
00100000000000000000000002222000000000000001
00100000000000000000000000000000000000000001
00100000000000000000000000000000222222222001
00100000000000000000000000000000000000000001
00100000000000000000000000000000000000000001
00100000000000000000000000000000222222222221
00100000000000000000000000000000111111111111
00100000000000002220000000000000000000000001
00100000000000001110000000000000000000000001
00100000000000001110000000002200000000000001
10100000000000001110000000021100000000000001
22222222222200001110000000211100000000000001
11111111111100001110000002111100000000000001
11111111111100001110002221111100000000000001
11111111111100001110001111111100000000000001
11111111111133331113331111111133333333333331